{
  "nombre": "Arcade",
  "dificultad": "hard",
"config": {
    "neonColor": "#00fff7",
    "gridSize": 40
},
"mapa": [
    [1,1,1,1,1,1,1,1,1,1,1,1,1,1,1],
    [1,3,0,0,0,0,0,0,0,0,0,0,0,0,1],
    [1,0,1,1,1,1,1,1,1,1,1,1,1,0,1],
    [1,0,0,0,0,0,0,1,0,0,0,0,0,0,1],
    [1,1,1,1,1,1,0,1,0,1,1,1,1,1,1],
    [1,0,0,0,0,1,0,1,0,1,0,0,0,0,1],
    [1,0,1,1,0,1,1,1,0,1,0,1,1,0,1],
    [1,0,1,0,0,0,0,0,0,0,0,0,1,0,1],
    [1,0,1,0,1,1,1,1,1,1,1,0,1,0,1],
    [1,0,0,0,1,0,1,0,0,0,1,0,0,0,1],
    [1,1,1,0,1,0,1,0,1,0,1,0,1,1,1],
    [1,0,0,0,0,0,1,0,1,0,0,0,0,0,1],
    [1,0,1,1,1,1,1,0,1,1,1,1,1,0,1],
    [1,0,0,0,0,0,0,0,0,0,0,0,0,0,1],
    [1,0,1,1,0,1,1,1,1,1,0,1,1,0,1],
    [1,0,0,0,0,1,0,0,0,1,0,0,0,0,1],
    [1,0,1,1,1,1,0,1,0,1,1,1,1,0,1],
    [1,0,0,0,1,0,0,1,0,0,0,0,0,0,1],
    [1,1,1,1,1,0,1,1,1,1,1,1,1,1,1],
    [1,0,0,0,1,0,0,0,0,0,1,0,0,0,1],
    [1,0,1,0,1,0,1,1,1,0,1,0,1,0,1],
    [1,0,1,0,0,0,1,1,1,0,0,0,1,0,1],
    [1,0,1,1,1,0,1,1,1,0,1,1,1,0,1],
    [1,0,0,0,1,0,0,0,0,0,1,0,0,0,1],
    [1,1,1,0,1,1,1,0,1,0,1,0,1,1,1],
    [1,0,0,0,0,0,1,0,1,0,0,0,0,0,1],
    [1,0,1,1,1,0,1,0,1,0,1,1,1,0,1],
    [1,0,1,0,0,0,0,0,0,0,0,0,1,0,1],
    [1,0,1,0,1,1,1,1,1,1,1,0,1,0,1],
    [1,0,0,0,1,0,0,0,0,0,1,0,0,0,1],
    [1,0,1,1,1,0,1,1,1,0,1,1,1,0,1],
    [1,0,0,0,0,0,1,0,1,0,0,0,0,0,1],
    [1,0,1,1,1,1,1,0,1,1,1,1,1,1,1],
    [1,0,0,0,0,0,0,0,0,0,0,1,1,1,1],
    [1,1,1,1,0,1,1,1,1,1,0,1,1,1,1],
    [1,0,0,0,1,1,0,0,0,1,0,0,0,0,1],
    [1,0,1,0,1,1,0,1,0,1,1,1,1,0,1],
    [1,0,0,0,0,0,0,1,0,0,0,0,0,0,1],
    [1,1,1,0,1,1,1,1,1,1,1,1,1,1,1],
    [1,0,0,0,1,0,0,0,0,0,1,0,0,0,1],
    [1,0,1,0,1,0,1,1,1,0,1,0,1,0,1],
    [1,0,1,0,0,0,1,0,0,0,0,0,1,0,1],
    [1,0,1,1,1,1,1,1,1,1,1,1,1,0,1],
    [1,0,0,0,0,0,0,0,0,0,0,0,0,0,1],
    [1,1,1,1,1,1,1,1,1,1,1,1,1,0,1],
    [1,0,0,0,0,0,0,0,0,0,0,0,0,0,1],
    [1,0,1,1,1,1,1,1,1,1,1,1,1,1,1],
    [1,0,0,0,0,0,0,0,0,0,0,0,0,0,1],
    [1,1,1,1,1,1,1,1,1,1,1,1,1,0,1],
    [1,0,0,0,0,0,0,0,0,0,0,0,0,0,1],
    [1,0,1,1,1,1,1,1,1,1,1,1,1,1,1],
    [1,0,0,0,0,0,0,0,0,0,0,0,0,0,1],
    [1,1,1,1,1,1,1,1,1,1,1,1,1,1,1]
  ],
  "zombies": [
    {"x": 3, "y": 35}, {"x": 11, "y": 30}, {"x": 5, "y": 25},
    {"x": 9, "y": 20}, {"x": 2, "y": 15}, {"x": 12, "y": 10},
    {"x": 7, "y": 5}
  ]
}