{
  "nombre": "nvl5",
  "dificultad": "hard",
  "config": { "gridSize": 40, "neonColor": "#00fff7" },
  "mapa": [
    [1,1,1,1,1,1,1,1,1,1,1,1,1,1,1,1,1,1,1,1,1,1],
    [1,3,0,0,1,0,0,0,0,0,1,0,0,0,0,0,1,0,0,0,0,1],
    [1,1,1,0,1,0,1,1,1,0,1,0,1,1,1,0,1,0,1,1,0,1],
    [1,0,0,0,0,0,1,0,0,0,0,0,1,0,0,0,0,0,1,0,0,1],
    [1,0,1,1,1,1,1,0,1,1,1,1,1,0,1,1,1,1,1,0,1,1],
    [1,0,0,0,1,0,0,0,1,0,0,0,0,0,1,0,0,0,1,0,0,1],
    [1,1,1,0,1,0,1,0,1,0,1,1,1,0,1,0,1,0,1,1,0,1],
    [1,0,0,0,0,0,1,0,0,0,1,0,0,0,0,0,1,0,0,0,2,1],
    [1,1,1,1,1,1,1,6,1,1,1,1,1,1,1,1,1,1,1,1,1,1]
  ],
  "zombies": [
    {"x": 5, "y": 3},
    {"x": 15, "y": 5}
  ]
}
