{
    "nivel": "3",
    "nombre": "Level 3 - The last game before the zombies",
    "mapa": [
        "1,1,1,1,1,1,1,1,1,1,1,1,1,1,1",
        "1,0,0,0,0,0,0,0,1,S,0,0,0,1,1",
        "1,0,1,1,1,1,1,0,0,0,0,0,0,0,1",
        "1,0,1,1,1,1,1,1,1,1,1,1,o,1,1",
        "1,0,0,0,0,0,0,1,1,1,1,o,o,o,1",
        "1,1,1,1,1,0,0,o,o,1,1,o,o,o,1",
        "1,1,1,1,1,0,1,1,1,1,1,o,o,o,1",
        "1,1,1,0,0,0,0,0,0,0,1,o,o,o,1",
        "1,1,1,0,1,1,1,1,1,0,1,o,o,o,1",
        "1,1,0,0,0,0,1,0,0,0,1,o,o,o,1",
        "1,1,0,1,1,1,1,0,1,1,1,1,o,1,1",
        "1,0,0,0,0,1,1,0,0,0,0,0,0,0,1",
        "1,0,1,1,0,1,1,1,1,1,1,1,0,1,1",
        "1,0,1,1,0,0,0,0,0,0,0,0,0,1,1",
        "1,0,1,1,1,1,1,1,1,1,1,1,1,1,1",
        "1,o,o,o,o,o,o,o,o,o,o,o,o,o,1",
        "1,1,1,1,1,1,1,1,1,1,1,1,1,1,1"
    ]
}