{
  "nivel": 1,
  "nombre": "La Cripta Amarilla",
  "mapa": [
    "1,1,1,1,1,1,1,1,1,1,1,1,1,1,1",
    "1,0,0,0,0,0,0,0,0,0,0,0,0,0,1",
    "1,0,1,1,1,1,1,0,1,1,1,1,1,0,1",
    "1,0,0,0,0,0,1,0,0,0,0,0,0,0,1",
    "1,1,1,1,1,1,1,0,1,1,1,1,1,1,1",
    "1,S,1,o,o,o,o,0,0,1,0,0,0,0,1",
    "1,0,0,1,1,1,1,1,0,0,0,1,1,0,1",
    "1,1,0,1,1,1,1,1,1,1,0,1,o,0,1",
    "1,0,0,0,0,0,0,0,0,0,0,1,o,0,1",
    "1,1,0,1,1,1,1,1,1,1,1,1,1,0,1",
    "1,1,0,0,0,0,0,0,0,0,0,0,0,0,1",
    "1,1,1,1,1,1,1,1,1,1,1,1,1,1,1"
  ]
}