{
     "nivel": 6,
    "nombre": "Nivel 6",
    "mapa": [
        "1,1,1,1,1,1,1,1,1,1,1,1,1,1,1,1",
        "1,0,0,0,1,1,1,1,1,1,1,1,S,1,1,1",
        "1,0,1,0,0,0,0,0,0,0,0,1,o,1,1,1",
        "1,0,1,1,1,1,1,1,1,1,0,0,m,0,0,1",
        "1,0,0,0,0,0,0,0,0,1,1,1,o,o,o,1",
        "1,1,1,1,1,1,1,1,0,1,1,1,m,1,o,1",
        "1,1,1,1,1,1,0,0,0,0,1,1,o,o,o,1",
        "1,1,1,1,0,0,0,1,1,0,1,1,m,1,o,1",
        "1,1,1,1,0,1,1,1,1,0,0,1,o,o,o,1",
        "1,1,1,0,0,0,0,1,1,1,0,1,m,1,o,1",
        "1,0,0,0,1,1,m,m,Z,m,m,1,o,o,o,1",
        "1,0,1,1,1,1,m,m,Z,m,m,1,m,1,o,1",
        "1,0,1,1,0,0,m,m,1,m,m,1,o,o,o,1",
        "1,0,1,1,o,1,1,1,1,1,1,1,m,1,o,1",
        "1,0,1,1,o,o,o,o,o,o,o,1,o,o,o,1",
        "1,0,0,0,0,m,m,m,m,m,0,0,m,1,o,1",
        "1,1,1,1,o,o,o,o,o,o,o,1,o,o,o,1",
        "1,1,1,1,1,1,1,1,1,1,1,1,1,1,o,1",
        "1,o,o,o,o,o,o,o,o,o,o,Z,o,o,o,1",
        "1,1,1,1,1,1,1,1,1,1,1,1,1,1,1,1"
    ]
}