{
    "nivel": 5,
    "nombre": "Nivel 5 - The first real challenge",
    "mapa": [
        "1,1,1,1,1,1,1,1,1,1,1,1,1,1,1",
        "1,0,0,0,0,0,0,1,1,1,1,o,o,o,1",
        "1,o,o,o,o,o,o,o,o,Z,o,o,o,o,1",
        "1,0,1,1,1,o,o,o,o,o,o,o,1,0,1",
        "1,0,1,1,1,0,1,1,1,1,1,1,1,0,1",
        "1,0,0,0,1,0,0,0,0,0,1,0,1,0,1",
        "1,1,1,0,1,1,1,1,1,0,0,0,1,0,1",
        "1,1,1,0,1,1,1,1,1,1,1,1,1,0,1",
        "1,0,0,0,0,0,0,0,0,0,1,1,1,0,1",
        "1,0,0,0,o,o,o,o,o,0,o,Z,1,0,1",
        "1,1,o,1,1,1,0,0,0,0,0,0,1,0,1",
        "1,o,o,o,1,1,1,1,1,1,1,0,1,0,1",
        "1,Z,o,o,o,o,o,o,o,o,o,o,o,o,1",
        "1,1,1,1,1,1,1,1,1,1,1,0,1,1,1",
        "1,1,1,1,1,1,1,1,1,0,0,0,0,0,1",
        "1,S,0,0,0,0,0,0,0,0,0,0,0,0,1",
        "1,1,1,1,1,1,1,1,1,1,1,1,1,1,1",
        "1,1,1,1,1,1,1,1,1,1,1,1,1,1,1"
    ]
}