{
"nivel": "1",
"nombre": "Level 4 - The patrolling zombie",
"mapa": [
    "1,1,1,1,1,1,1,1,1,1,1,1,1,1,1",
    "1,0,0,0,0,0,0,0,1,1,1,1,S,1,1",
    "1,1,1,1,0,0,0,0,0,0,0,0,0,0,1",
    "1,1,1,1,0,1,1,1,1,1,1,1,0,1,1",
    "1,1,1,1,0,1,1,1,1,0,0,0,0,1,1",
    "1,1,Z,o,o,o,o,o,1,0,1,1,1,1,1",
    "1,1,0,1,1,1,1,1,1,0,0,0,0,0,1",
    "1,1,0,0,0,0,1,1,1,1,1,o,0,1,1",
    "1,1,1,1,1,0,0,0,0,0,1,o,0,1,1",
    "1,1,1,1,1,1,1,1,1,0,o,o,0,1,1",
    "1,1,1,1,Z,o,o,o,o,0,0,0,0,1,1",
    "1,1,1,1,1,1,1,1,1,1,1,1,1,1,1"
    ]
}