{
  "nivel": 2,
  "nombre": "La dificultad aumenta",
  "mapa": [
    "1,1,1,1,1,1,1,1,1,1,1,1,1,1,1",
    "1,0,0,0,0,0,0,0,0,0,0,0,0,0,1",
    "1,0,0,0,0,0,0,0,0,0,1,1,0,0,1",
    "1,1,1,1,1,1,1,1,1,0,1,1,0,0,1",
    "1,0,0,0,0,0,0,1,1,0,1,1,0,0,1",
    "1,0,1,1,1,1,0,0,0,0,1,1,0,0,1",
    "1,0,0,0,0,1,1,1,1,1,1,1,0,0,1",
    "1,1,0,0,0,0,0,0,1,1,1,1,0,0,1",
    "1,1,1,1,1,0,0,0,1,1,1,1,0,0,1",
    "1,1,1,1,1,0,1,1,1,1,1,1,0,0,1",
    "1,0,S,1,1,0,1,1,1,1,1,1,0,1,1",
    "1,0,0,0,0,0,0,0,0,0,0,1,0,1,1",
    "1,1,0,1,1,1,1,1,1,1,1,1,0,1,1",
    "1,0,0,0,0,0,0,0,0,0,0,0,0,1,1",
    "1,1,1,1,1,1,1,1,1,1,1,1,1,1,1"
  ]
}